oo    zzz z zzz      oo
oo    z z z z z      oo
oo    z z z z z      oo
oo   w   azdd  w   oo
 oo  w xa z cx w  oo
  oo w xc z dx w oo
  oo w xa z cx w oo
  oo w xc z dx w oo
  oo w x  z cx w oo
  oo w xc z  x w oo
  oo w x  z cx w oo
  oo w xc z  x w oo
  oo w  x x x  w oo
  oo w  d x a  w oo
  oo w zcz zcz w oo
  oox xz z z zx xoo
  oo    c   c    oo
  oo      c      oo
  oo    x x x    oo
  oo             oo
  oo             oo
  oo             oo
  oo......P......oo