####.####
###>.####
###.o####
###.<####
###..<###
####..###
#####.###
#####A###
####>.###
###>..###
###.oo###
##..oo###
###.<####
####.####
####P####