#.........#
o.........o
o.........o
#.........#
o.........o
o.........o
#o.......o#
o*<.....>*o
o..<...>..o
#...<.>...#
o..>*.*<..o
o.........o
#.........#
o..A...A..o
o.........o
#.........#
o..A...A..o
o.........o
#.........#
o..A.*.A..o
o.........o
#>>.....<<#
o..*...*..o
o....*....o
#.........#
o.........o
o....P....o

